R 1000 700


NO ./textures/crafting_table_side.png


SO ./textures/chiseled_red_sandstone.png



            EA ./textures/chiseled_red_sandstone.png



            WE ./textures/crafting_table_side.png



            S ./textures/barrel.png

C 135,206,235
F 128,128,128

11111111111111111111111111111  111
1002220000110000000000100000111101
1000000001110000000001010001000011
10010W0000000000000000101000111111
10110000011100000001000000001
10000000001100000111011110001
111101111111110111000000100011111
111101111111110111010100100011111
11000000110101011100000010001
10000000000000001100000010001
10000000000000001101010010001
110000001101010111110111100011
11110111111101011111111110001
11111111111111111111111110001
                        10001
          1111          10001
          1001          10001
          1111          11111